1111111111111
101100000C001
1010011111001
1P1011000E001
1111111111111