1111111111111
100100000C001
1000011111001
1P0011000E001
1111111111111